ann -> ann
tha -> bi
bha -> bi
gu -> gu
anns -> anns
aig -> aig
chaidh -> rach
robh -> bi
airson -> airson
ri -> ri
seo -> seo
bho -> bo
nan -> n
mi -> mi
baile -> baile
mu -> mu
cha -> ca
san -> s
eadar -> eadar
alba -> alba
bheil -> beil
th -> th
nuair -> nuair
ainm -> ainm
eile -> eile
bhaile -> baile
bhith -> bith
daoine -> daoine
aige -> aige
às -> às
fhèin -> fèan
mòr -> mòr
ris -> ris
co -> co
duine -> duine
eilean -> eil
chan -> c
fuireach -> fuire
eil -> bi
iar -> iar
gàidhlig -> gàidhlig
àite -> àite
à -> à
bliadhna -> bliadhna
taobh -> taobh
rinn -> rinn
dèidh -> dèidh
tuath -> tuath
thuirt -> tuirt
cuideachd -> cuideachd
nam -> nam
bh -> bh
chuir -> cuir
dà -> dà
deas -> deas
siorrachd -> siorrachd
ceann -> ceann
neo -> neo
latha -> latha
mhòr -> mòr
cho -> co
fhuair -> faigh
beurla -> beurla
dhen -> den
faisg -> faisg
deug -> deug
suidhichte -> suidhichte
chur -> cur
dùn -> dùn
taigh -> taigh
linn -> linn
sgìre -> sgìre
rèir -> rèir
bhon -> bon
aca -> aca
dol -> dol
litir -> litir
thàinig -> thig
roinn -> roinn
inbhir -> inbhir
gus -> gus
chiad -> ciad
àm -> àm
bhiodh -> bi
obair -> obair
ʼs -> `s
chuid -> cuid
luchd -> luchd
dha -> da
seann -> seann
bu -> bu
dùthcha -> dùthcha
rugadh -> rug
dè -> dè
bidh -> bi
cuid -> cuid
falbh -> falbh
oilthigh -> oilthigh
dhan -> d
prìomh -> prìomh
comhairle -> comhairle
ath -> ath
beag -> beag
uile -> uile
iain -> iaan
fo -> fo
ùr -> ùr
rìgh -> rìgh
bhliadhna -> bliadhna
thoirt -> toirt
ràdh -> ràdh
nis -> nis
diugh -> diugh
w﻿ -> w﻿
ciallachadh -> ciallach
àirde -> àirde
nas -> nas
mara -> mara
ged -> ged
àrd -> àrd
ga -> ga
mac -> mac
ceud -> ceud
neach -> ne
uair -> uair
motha -> motha
dhèanamh -> dèanamh
uisge -> uisge
fhathast -> fathast
cionn -> cionn
èideann -> èideann
trì -> trì
mòran -> mòr
bith -> bi
ìre -> ìre
ainmeil -> ainmeil
ghàidhlig -> gàidhlig
còmhla -> còmhla
dùthaich -> dùthaich
leth -> leth
dhuibh -> duibh
bheag -> beag
steach -> ste
aghaidh -> aghaidh
innse -> innse
sgoil -> sgoil
eaglais -> eaglais
obar -> obar
dhe -> de
dìreach -> dìre
cheann -> ceann
glaschu -> glaschu
sgrìobh -> sgrìobh
dèanamh -> dèanamh
leabhar -> leabhar
dhùn -> dùn
seachad -> seachad
dheathain -> deathaan
stèidheachadh -> stèidheach
mun -> mun
biodh -> biodh
eileanan -> eil
aonaichte -> aonaichte
chuimrigh -> cuimrigh
toirt -> toirt
nàiseanta -> nàiseanta
cilemeatair -> cilemeatair
ro -> ro
rathad -> rathad
chaochail -> caochail
dheireadh -> deire
josé -> josè
sam -> sam
lorg -> lorg
thu -> tu
oir -> oir
gleann -> gleann
measg -> measg
chomharran -> comharr
dhol -> dol
deach -> de
bharrachd -> barrachd
esan -> es
beinn -> beinn
rud -> rud
ghabh -> gabh
chionn -> cionn
uill -> uill
thogail -> togail
chèile -> cèile
seachd -> seachd
thuath -> tuath
ruige -> ruige
contae -> contae
thachair -> tachair
coltach -> colt
tighinn -> tighinn
sluagh -> sluagh
dàrna -> dàrna
tro -> tro
meadhan -> meadh
bheachd -> beachd
aice -> aice
thòisich -> tòisich
orra -> orra
fada -> fada
gabhail -> gabhail
aithris -> aithris
deireadh -> deire
mus -> mus
thathar -> tathar
leòr -> leòr
rithist -> rithist
ge -> ge
lunnainn -> lunnainn
fios -> fios
stàitean -> stàit
ais -> ais
sgrìobhadh -> sgrìobh
bi -> bi
toiseach -> toise
cille -> cille
oidhche -> oidhche
dheth -> deth
dòcha -> dòcha
dheas -> deas
riaghaltas -> riaghaltas
abhainn -> abhainn
iarraidh -> iarraidh
mìle -> mìle
dòigh -> dòigh
làidir -> làidir
ceithir -> ceithir
dheidhinn -> deidhinn
urrainn -> urrainn
dubh -> dubh
tà -> tà
srath -> srath
bruidhinn -> bruidhinn
bhios -> bios
ochd -> ochd
facal -> facal
dhiubh -> diubh
turas -> turas
nochd -> nochd
àireamh -> àireamh
feadh -> fe
feadhainn -> feadhainn
thall -> tall
fhaighinn -> faighinn
timcheall -> timcheall
nise -> nise
tè -> tè
cànan -> càn
canar -> canar
alasdair -> alasdair
thaobh -> taobh
sàs -> sàs
tìr -> tìr
taic -> taic
dhaibh -> daibh
thairis -> tairis
chunnaic -> faic
cleachdadh -> cleachd
dhiù -> diù
shluaigh -> sluaigh
sgitheanach -> sgithean
iomadh -> iom
bhuannaich -> buannaich
còig -> còig
beò -> beò
oirre -> oirre
nuadh -> nu
muinntir -> muinntir
suas -> suas
athair -> athair
duais -> duais
rìoghachd -> rìoghachd
fìor -> fìor
bàs -> bàs
eachdraidh -> eachdraidh
thill -> till
òg -> òg
cumail -> cumail
dhà -> dà
eisimpleir -> eisimpleir
nighean -> nigh
dhaoine -> daoine
dòmhnall -> dòmhnall
siar -> siar
beul -> beul
albannach -> albann
tric -> tric
ainmean -> ainm
agam -> agam
dithis -> dithis
ùine -> ùine
suidhe -> suidhe
riamh -> riamh
seòrsa -> seòrsa
thèid -> rach
buaidh -> buaidh
gàidhealtachd -> gàidhealtachd
pàirt -> pàirt
obrach -> obr
àird -> àird
seachdain -> seachdaan
dhuinn -> duinn
fàs -> fàs
sia -> sia
ghàidhealtachd -> gàidhealtachd
dh’fhalbh -> d’fhalbh
beagan -> beag
fhàgail -> fàgail
allt -> allt
sgàth -> sgàth
cogadh -> cog
dùil -> dùil
fheàrr -> feàrr
cuimris -> cuimris
dhachaigh -> dachaigh
againn -> againn
faighinn -> faighinn
aibhne -> aibhne
roimhe -> roimhe
cò -> cò
thog -> tog
bhean -> b
caisteal -> caisteal
tuilleadh -> tuille
còrr -> còrr
drochaid -> drochaid
fhear -> fear
sònraichte -> sònraichte
chunntais -> cunntais
ruith -> ruith
sgìrean -> sgìr
ràinig -> ràinig
beatha -> beatha
là -> là
bailtean -> baile
leum -> leum
uabhasach -> uabhas
òran -> òr
dhomh -> domh
dh -> dh
earra -> earra
airgead -> airgead
naomh -> naomh
sùil -> sùil
crìochan -> crìoch
slighe -> slighe
phàirt -> pàirt
leithid -> leithid
bheurla -> beurla
fhacal -> facal
làn -> làn
eòlach -> eòl
seumas -> seumas
thogadh -> tog
eòrpa -> eòrpa
làimh -> làimh
tron -> tron
droch -> droch
teaghlach -> teaghl
agaibh -> agaibh
phrìomh -> prìomh
coimhead -> coimhead
cheud -> ceud
caerdydd -> caerdydd
clann -> clann
bheatha -> beatha
poileataigs -> poileataigs
mhuir -> muir
ros -> ros
sheachdain -> seachdaan
laighe -> laighe
cinnteach -> cinnte
cill -> cill
ruadh -> ru
clach -> cl
atharrachadh -> atharrach
bheinn -> beinn
clachan -> clach
chaill -> caill
mhath -> math
fearann -> fearann
chruthachadh -> cruthach
innis -> innis
àraidh -> àraidh
saoghal -> saoghal
eilein -> eilean
muigh -> muigh
gille -> gille
ghàidheal -> gàidheal
fàsach -> fàs
pàrtaidh -> pàrtaidh
chleachdadh -> cleachd
cudromach -> cudrom
leig -> leig
sasainn -> sasainn
talamh -> talamh
ionadail -> ionadail
thaghadh -> tagh
meadhanach -> meadhan
mòra -> mòra
laideann -> laideann
fhad -> fad
nochdadh -> nochd
naidheachd -> naidheachd
spàinntis -> spàinntis
mì -> mì
tu -> tu
pheairt -> peairt
rudeigin -> rudeigan
sìos -> sìos
beanntan -> beannt
seach -> se
sgioba -> sgioba
eòlas -> eòlas
chuireadh -> cuire
èirinn -> èirinn
mheadhanach -> meadhan
bheir -> beir
ghlaschu -> glaschu
aonghas -> aonghas
togail -> togail
leasachadh -> leasach
mhinistear -> ministear
lodainn -> lodainn
locha -> locha
phòs -> pòs
rois -> rois
phàrlamaid -> pàrlamaid
mullach -> mull
ionnsaigh -> ionnsaigh
ainmeachadh -> ainmeach
chànan -> càn
buidheann -> buidheann
làrach -> làr
leantainn -> leantainn
chòir -> còir
ghleann -> gleann
maría -> marìa
feumaidh -> feumaidh
beinne -> beinne
breatainn -> breatainn
dearbh -> dearbh
lochan -> loch
dàmhair -> dàmhair
àir -> àir
fheadhainn -> feadhainn
roinne -> roinne
glè -> glè
iomairt -> iomairt
cumanta -> cumanta
staigh -> staigh
stèidhichte -> stèidhichte
iuchar -> iuchar
chumail -> cumail
bhall -> ball
bhuineadh -> buine
arcaibh -> arcaibh
adhart -> adhart
chluaidh -> cluaidh
nì -> nì
pàrlamaid -> pàrlamaid
dh’iarr -> d’iarr
sluaigh -> sluaigh
sultain -> sultaan
oifigeil -> oifigeil
phris -> pris
sgùrr -> sgùrr
chuala -> cluin
ceart -> ceart
fichead -> fichead
ars -> ars
stàite -> stàite
ciùil -> ciùil
mhòir -> mòir
eaglaise -> eaglaise
smaoineachadh -> smaoineach
rannsachadh -> rannsach
friù -> friù
mhàin -> màan
sgrìobhadair -> sgrìobhadair
teine -> teine
carson -> carson
troigh -> troigh
dùbhlachd -> dùbhlachd
stèisean -> stèis
dhealaichte -> dealaichte
fhada -> fada
blàr -> blàr
afraga -> afraga
taighean -> taigh
bòrd -> bòrd
calum -> calum
stad -> stad
gearmailtis -> gearmailtis
